000000000000000000000000000000
000000000000000000000000000000
000000000000000000000000000000
000000000000000000000000000000
000000000000000000000000000000
000000000000000000000000000000
000000000000000000000000000000
000000000000000000000000000000
000000000000000000000000000000
111000000000000000000000000111
221111111111111111111111111122
222222222222222222222222222222
222222222222222222222222222222
332222222222222222222222222233
333322222222222222222222223333
333333333333333333333333333333
333333333333333333333333333333